6 6
2 5
0 0 0 2 2 0
0 0 1 2 0 0
0 0 0 0 0 0
2 0 0 0 0 0
0 0 0 0 0 0
0 0 0 0 0 0
0
1
3 2  5 4

