6 5
3 4
2 0 0 0 2 2
2 0 1 3 2 0
1 3 0 2 2 0
0 2 2 3 1 2
0 0 0 0 0 0
0
1
5 0  4 4
