6 6
1 0
0 2 0 0 3 0
0 0 1 0 2 0
0 0 1 0 1 0
3 0 0 1 3 0
0 0 2 0 1 0
0 0 0 0 0 0
0
1
4 4 0 4


